Los gatos duermen debajo de los árboles.	EMPTY | Cats sleep under the trees.	cats, sleep, trees
El niño escucha a la rana.	EMPTY | The child listens to the frog.	child, listen, frog
El chico nada en el rio.	EMPTY | The boy swims in the river.	boy, swim, river
El pescador está en el mar.	EMPTY | The fisherman is in the sea.	fisherman, be, sea
El perro duerme en la cesta.	EMPTY | The dog sleeps in the basket.	dog, sleep, basket
La niña aplaude con los pies.	EMPTY | The girl claps with her feet.	girl, clap, her, feet
El niño juega con el tren.	EMPTY | The child plays with the train.	child, play, train
El lobo llama a la puerta.	EMPTY | The wolf knocks on the door.	wolf, knock, door
Imanol va al hotel.	EMPTY | Imanol goes to the hotel.	Imanol, go, hotel
El avión vuela encima de las nubes.	EMPTY | The plane flies over the clouds.	plane, fly, clouds
El niño escucha el pájaro.	EMPTY | The child listens to the bird.	child, listen, bird
La bola es como una pelota.	EMPTY | The ball is like a ball.	ball, be, a, ball
El tenedor está en el comedor.	EMPTY | The fork is in the dining room.	fork, be, dining, room
El niño nada en la piscina.	EMPTY | The child swims in the pool.	child, swim, pool
La mariposa vuela por el campo.	EMPTY | The butterfly flies through the field.	butterfly, fly, field
El mono piensa en un plátano.	EMPTY | The monkey thinks of a banana.	monkey, think, a, banana
El gato mira el pez.	EMPTY | The cat looks at the fish.	cat, look, fish
Mamá lee con la niña.	EMPTY | Mom reads with the girl.	mom, read, girl
La niña juega con las fichas.	EMPTY | The girl plays with the sheets.	girl, play, sheets
Los niños juegan con la pelota.	EMPTY | The kids play with the ball.	kids, play, ball
La niña juega con las piedras.	EMPTY | The girl plays with the stones.	girl, play, stones
Yo juego en el parque con el jabalí.	EMPTY | I play in the park with the boar.	play, park, with, boar
La niña monta en el triciclo.	EMPTY | The girl rides on the tricycle.	girl, ride, tricycle
El gato duerme encima del armario.	EMPTY | The cat sleeps on top of the closet.	cat, sleep, top, of, closet
La niña nada en la biblioteca.	EMPTY | The girl swims in the library.	girl, swim, library
El gato duerme encima del sofá.	EMPTY | The cat sleeps on the couch.	cat, sleep, couch
Yo me baño en el fregadero.	EMPTY | I bathe in the sink.	bathe, sink
El pez nada en la bañera.	EMPTY | The fish swims in the bathtub.	fish, swim, bathtub
El caballo corre en el mar.	EMPTY | The horse runs in the sea.	horse, run, sea
El niño juega con el barco.	EMPTY | The child plays with the boat.	child, play, boat
Dos coches chocan en la calle.	EMPTY | Two cars collide on the street.	two, cars, collide, street
El gato duerme encima de la guitarra.	EMPTY | The cat sleeps on top of the guitar.	cat, sleep, top, of, guitar
El papá y el niño pescan con la caña en el río.	EMPTY | Dad and the child fish with the reed in the river.	dad, child, fish, reed, in, river
La guitarra está en el carro.	EMPTY | The guitar is in the cart.	guitar, be, cart
El niño escucha el gato.	EMPTY | The boy listens to the cat.	boy, listen, cat
El dinero está en el monedero.	EMPTY | The money is in the purse.	money, be, purse
El globo vuela encima de las montañas.	EMPTY | The balloon flies over the mountains.	balloon, fly, mountains
Oscar está en el bar.	EMPTY | Oscar is at the bar.	Oscar, be, bar
La niña escucha música.	EMPTY | The girl listens to music.	girl, listen, music
Los delfines y la tortuga nadan en el mar.	EMPTY | Dolphins and turtle swim in the sea.	dolphins, turtle, swim, sea
La chica nada en la piscina.	EMPTY | The girl swims in the pool.	girl, swim, pool
El ruiseñor canta en la rama.	EMPTY | The nightingale sings on the branch.	nightingale, sing, branch
El pájaro vuela por el cielo.	EMPTY | The bird flies through the sky.	bird, fly, sky
Mamá hace puré con la batidora.	EMPTY | Mom mashes with the blender.	mom, mash, blender
Los niños van al colegio en autobús.	EMPTY | Children go to school by bus.	children, go, school, by, bus
La niña escribe con un lápiz en el papel.	EMPTY | The girl writes with a pencil on paper.	girl, write, a, pencil, on, paper
Lolo juega con el balón.	EMPTY | Lolo plays with the ball.	Lolo, play, ball
El pintor pinta en el mantel.	EMPTY | The painter paints on the tablecloth.	painter, paint, tablecloth
El papá compra en el supermercado.	EMPTY | Dad buys at the supermarket.	dad, buy, supermarket
El niño mira las estrellas con el telescopio.	EMPTY | The child looks at the stars with the telescope.	child, look, stars, with, telescope
El lobo se acuesta en la cama.	EMPTY | The wolf lies on the bed.	wolf, lie, bed
Yo me baño en la bañera.	EMPTY | I bathe in the bathtub.	bathe, bathtub
Yo juego en el parque con los niños.	EMPTY | I play in the park with the children.	play, park, with, children
Los niños juegan con las hojas de los árboles.	EMPTY | The children play with the leaves of the trees.	children, play, leaves, of, trees
La niña bebe con la pajita.	EMPTY | The girl drinks with the straw.	girl, drink, straw
La niña juega con el agua.	EMPTY | The girl plays with water.	girl, play, water
El chico flota con el churro.	EMPTY | The boy floats with the churro.	boy, float, churro
Dos coches chocan en el cielo.	EMPTY | Two cars collide in the sky.	two, cars, collide, sky
El torero mira al toro.	EMPTY | The bullfighter looks at the bull.	bullfighter, look, bull
La jirafa corre en la selva.	EMPTY | The giraffe runs in the jungle.	giraffe, run, jungle
El lagarto está en la lavadora.	EMPTY | The lizard is in the washing machine.	lizard, be, washing, machine
El niño baja por el tobogán.	EMPTY | The child goes down the slide.	child, go, slide
El loro mira al caracol.	EMPTY | The parrot looks at the snail.	parrot, look, snail
Papá nada en la piscina.	EMPTY | Daddy swims in the pool.	daddy, swim, pool
Los niños van al colegio en avión.	EMPTY | Children go to school by plane.	children, go, school, by, plane
La moto está en el taller.	EMPTY | The motorcycle is in the workshop.	motorcycle, be, workshop
Ese rey es de rusia.	EMPTY | That king is from Russia.	that, king, be, Russia
La niña escucha música.	EMPTY | The girl listens to music.	girl, listen, music
Yo duermo en la lavadora.	EMPTY | I sleep in the washing machine.	sleep, washing, machine
El libro y el estuche están dentro del horno.	EMPTY | The book and the case are inside the oven.	book, case, be, oven
El lobo va al molino.	EMPTY | The wolf goes to the mill.	wolf, go, mill
El cerdo vive en la granja.	EMPTY | The pig lives on the farm.	pig, live, farm
El perro juega con el hueso.	EMPTY | The dog plays with the bone.	dog, play, bone
El niño monta en el cerdo.	EMPTY | The child rides on the pig.	child, ride, pig
La niña piensa en una bombilla.	EMPTY | The girl thinks of a light bulb.	girl, think, a, light, bulb
Los niños aprenden en el colegio.	EMPTY | Children learn at school.	children, learn, school
La niña se columpia en el columpio.	EMPTY | The girl swings on the swing.	girl, swing, swing
La tortuga nada en el mar.	EMPTY | The turtle swims in the sea.	turtle, swim, sea
La niña habla por teléfono.	EMPTY | The girl speaks on the phone.	girl, speak, phone
Los niños juegan con las construcciones.	EMPTY | Children play with constructions.	children, play, constructions
Los niños juegan con la nieve.	EMPTY | Children play with snow.	children, play, snow
Los delfines nadan en el mar.	EMPTY | Dolphins swim in the sea.	dolphins, swim, sea
El niño enciende la luz.	EMPTY | The boy turns on the light.	boy, turn, light
La chica nada en la piscina cubierta.	EMPTY | The girl swims in the indoor pool.	girl, swim, indoor, pool
Las abejas vuelan alrededor de la flor rosa.	EMPTY | Bees fly around the pink flower.	bees, fly, pink, flower
La abuela está en el armario.	EMPTY | Grandma is in the closet.	grandma, be, closet
El niño escucha música.	EMPTY | The child listens to music.	child, listen, music
El chico nada en el mar.	EMPTY | The boy swims in the sea.	boy, swim, sea
El pájaro nada por el mar.	EMPTY | The bird swims in the sea.	bird, swim, sea
La niña aplaude con las manos.	EMPTY | The girl claps with her hands.	girl, clap, her, hands
María va a la carnicería.	EMPTY | María goes to the butcher shop.	María, go, butcher, shop
La chica nada en la piscina.	EMPTY | The girl swims in the pool.	girl, swim, pool
Niño va a la panadería.	EMPTY | Boy goes to the bakery.	boy, go, bakery
La maleta está en el salón.	EMPTY | The suitcase is in the living room.	suitcase, be, living, room
El niño escucha la vaca.	EMPTY | The boy listens to the cow.	boy, listen, cow
La niña compra con el carrito.	EMPTY | The girl buys with the cart.	girl, buy, cart
El libro y el estuche están dentro de la mochila.	EMPTY | The book and the case are in the bag.	book, case, be, bag
El pez nada en el mar.	EMPTY | The fish swims in the sea.	fish, swim, sea
El bebé pasea en el coche.	EMPTY | The baby walks in the car.	baby, walk, car
Yo quiero jugar con el fuego.	EMPTY | I want to play with fire.	want, to, play, fire
Yo duermo en la cama.	EMPTY | I sleep in the bed.	sleep, bed
Miro el hilo con la lupa.	EMPTY | I look at the thread with the magnifying glass.	look, thread, with, magnifying glass
El niño mira la mariposa con la lupa.	EMPTY | The child looks at the butterfly with the magnifying glass.	child, look, butterfly, with, magnifying glass
El avión rojo vuela encima de las nubes.	EMPTY | The red plane flies up the clouds.	red, plane, fly, clouds
Voy a casa mi de abuela.	EMPTY | I go to my grandmother's house.	go, grandmother's house
Los niños pintan con un lapiz azul en papel blanco.	EMPTY | Children paint with a blue pencil on white paper.	children, paint, a, blue, pencil, on, paper
Las ovejas tienen mucha lana.	EMPTY | The sheep have a lot of wool.	sheep, have, a, lot, of, wool
El esquimal vive en un iglú.	EMPTY | The Eskimo lives in an igloo.	Eskimo, live, an, igloo
La niña lleva un paraguas.	EMPTY | The girl is carrying an umbrella.	girl, carry, an, umbrella
El niño lee el cuento de pinocho.	EMPTY | The child reads the Pinocho story.	child, read, Pinocho, story
Alguien ha roto la silla pequeña.	EMPTY | Someone has broken the small chair.	someone, break, small, chair
El esquimal vive en una cabaña.	EMPTY | The Eskimo lives in a cabin.	Eskimo, live, a, cabin
Las mujeres se visten de mantilla.	EMPTY | The women are dressed in mantillas.	women, wear, mantillas
La chica merienda bocadillo de chorizo y leche.	EMPTY | The girl has chorizo sandwich and milk.	girl, have, chorizo sandwich, milk
La casa de paja se rompe.	EMPTY | The straw house breaks.	straw, house, break
La bolsa de la fruta se ha roto.	EMPTY | The bag of fruit has been broken.	bag, of, fruit, be, broken
Esa zapatería tiene muchos zapatos.	EMPTY | That shoe store has many shoes.	that, shoe, store, have, many, shoes
La niña tiene las manos pintadas.	EMPTY | The girl has painted hands.	girl, have, Painted, hands
Quiero comer melón y limón.	EMPTY | I want to eat melon and lemon.	eat, melon, lemon
El lobo quiere comer a la abuela.	EMPTY | The wolf wants to eat grandma.	wolf, eat, grandma
Yo quiero comer.	EMPTY | I want to eat.	eat
El mayor hace una casa de piedra.	EMPTY | The oldest one makes a stone house.	oldest, one, make, a, stone, house
El lobo quiere comer a caperucita.	EMPTY | The wolf wants to eat Little Red Riding Hood.	wolf, eat, Little Red Riding Hood
Los cabritillos reconocieron la piel oscura del lobo.	cabritillos, reconocer, piel, oscuro, de, lobo | The kids recognized the dark skin of the wolf.	kids, recognize, dark, skin, of, wolf
La planta creció.	planta, crecer | The plant grew.	plant, grow
Todos quedaron sorprendidos de su disfraz tan bonito.	todos, quedar, sorprendido, de, su, disfraz, tan, bonito | Everyone was surprised by his beautiful costume.	everyone, be, surprise, by, his, beautiful, costume
El leñador cazó un jabalí.	leñador, cazar, un, jabalí | The woodcutter caught a boar.	woodcutter, catch, a, boar
Vi un topo en otoño.	ver, un, topo, en, otoño | I saw a mole in autumn.	see, a, mole, in, autumn
Juan cambió la vaca por habichuelas mágicas.	Juan, cambiar, vaca, por, habichuelas, mágico | Juan changed the cow for magic beans.	Juan, change, cow, for, magic, beans
Su mamá se enfadó.	su, mamá, se, enfadar | His mother got angry.	his, mother, get, angry
El lobo se relamía pensando en los cabritillos.	lobo, se, relamer, pensar, cabritillos | The wolf licked thinking about the kids.	wolf, lick, thinking, about, kids
El ogro bajó por la planta.	ogro, bajar, planta | The ogre went down by the plant.	ogre, go, down, by, plant
La mariposa se puso furiosa.	mariposa, se, poner, furioso | The butterfly was furious.	butterfly, be, furious
La gallina ponía huevos de oro.	gallina, poner, huevos, de, oro | The hen laid golden eggs.	hen, lay, golden, eggs
El lobo dormía.	lobo, dormir | The wolf slept.	wolf, sleep
La planta llegó hasta el cielo.	planta, llegar, cielo | The plant reached the sky.	plant, reach, sky
La gallina ponía huevos de oro.	gallina, poner, huevos, de, oro | The hen laid golden eggs.	hen, lay, golden, eggs
La rana subió a la rama.	rana, subir, rama | The frog climbed the branch.	frog, climb, branch
Me rompí el tobillo en el tobogán.	me, romper, tobillo, en, tobogán | I broke my ankle on the slide.	break, my, ankle, on, slide
Juan cortó la planta.	Juan, cortar, planta | Juan cut the plant.	Juan, cut, plant
El lobo feroz siguió a Caperucita.	lobo, feroz, seguir, Caperucita | The ferocious wolf followed Little Red Riding Hood.	ferocious, wolf, follow, Little Red Riding Hood
Los chicos acabaron borricos.	chicos, acabar, borrico | The boys ended up being donkeys.	boys, end, up, being, donkeys
Otra hija era Saturno.	otro, hija, ser, Saturno | Another daughter was Saturn.	another, daughter, be, Saturn
El ogro tenía un arpa mágica.	ogro, tener, un, arpa, mágico | The ogre had a magic harp.	ogre, have, a, magic, harp
Una señora viejecita les dio un borrador mágico.	un, señora, viejecito, le, dar, un, borrador, mágico | An old lady gave them a magic eraser.	an, old, lady, give, them, a, magic, eraser
Juan y su mamá vivieron felices.	Juan, su, mamá, vivir, feliz | Juan and his mother lived happily.	Juan, his, mother, live, happily
El arpa produjo diamantes.	arpa, producir, diamantes | The harp produced diamonds.	harp, produce, diamonds
La vaca quería estudiar en la escuela.	vaca, querer, estudiar, escuela | The cow wanted to study at school.	cow, want, to, study, school
Tenían una vaca vieja.	tener, un, vaca, viejo | They had an old cow.	they, have, an, old, cow
Su madrastra la hacía trabajar todo el día.	madrastra, lo, hacer, trabajar, todo, día | Her stepmother made her work all day.	her, stepmother, make, her, work, all, day
Ricitos de Oro se despertó asustada.	Ricitos, de, Oro, se, despertar, asustado | Goldilocks woke up scared.	Goldilocks, wake, up, scared
El lobo tiñó con harina sus patas.	lobo, teñir, harina, su, patas | The wolf dyed its legs with flour.	wolf, dye, its, legs, with, flour
El gusano de seda se enamoró de ella.	gusano, seda, se, enamorar, ella | The silkworm fell in love with her.	silkworm, fall, love, with, her
Pili ha metido un gol.	Pili, haber, meter, un, gol | Pili has scored a goal.	Pili, score, a, goal
Su madre la encontró llorando.	su, madre, la, encontrar, llorar | Her mother found her crying.	her, mother, find, her, crying
¿Qué llevas en la cesta?	qué, llevar, cesta, ? | What are you carrying in the basket?	what, you, carry, basket, ?
Mamá cabra va a comprar.	mamá, cabra, ir, comprar | Mom goat is going to buy.	mom, goat, buy
Solo estudiaba la vaca.	solo, estudiar, vaca | Only the cow studied.	only, cow, study
Juan encontró un castillo.	Juan, encontrar, castillo | Juan found a castle.	Juan, find, a, castle
Los cabritillos fueron felices.	cabritillos, ser, feliz | The kids were happy.	kids, be, happy
El duende pintó de color amarillo la casa del caracol.	duende, pintar, color, amarillo, casa, de, caracol | The goblin painted the snail's house yellow.	goblin, paint, snail's house, yellow
El cazador asustó al lobo.	cazador, asustar, lobo | The hunter frightened the wolf.	hunter, frighten, wolf
Arreglé la tubería con las tenazas.	arreglar, tubería, con, tenazas | I fixed the pipe with the tongs.	fix, pipe, with, tongs
El ogro tenía una gallina mágica.	ogro, tener, un, gallina, mágico | The ogre had a magic hen.	ogre, have, a, magic, hen
La niña está sentada en la roca.	niña, estar, sentado, en, roca | The girl is sitting on the rock.	girl, sit, rock
El ogro se fue.	ogro, se, ir | The ogre left.	ogre, leave
El alcalde no quiso pagar al flautista.	alcalde, no, querer, pagar, flautista | The mayor did not want to pay the flutist.	mayor, want, to, pay, flutist, not
La perra tuvo cachorros.	perra, tener, cachorros | The dog had puppies.	dog, have, puppies
El niño va a lanzar una bola de nieve.	niño, ir, lanzar, un, bola, de, nieve | The boy is going to throw a snowball.	boy, throw, a, snowball
El lobo llegó primero.	lobo, llegar, primero | The wolf arrived first.	wolf, arrive, first
Caperucita y la abuela fueron felices.	Caperucita, abuela, ser, feliz | Little Red Riding Hood and Grandma were happy.	Little Red Riding Hood, grandma, be, happy
El ogro se cayó.	ogro, se, caer | The ogre fell.	ogre, fall
No lo cambiaré.	no, lo, cambiar | I will not change it.	change, it, not
La niña está sentada en una roca.	niño, estar, sentado, en, un, roca | The girl is sitting on a rock.	girl, sit, a, rock
Los niños se reían.	niños, se, reír | The children laughed.	children, laugh
Juan subió por la planta.	Juan, subir, planta | Juan went up by the plant.	Juan, go, up, by, plant
La niña está sentada en un sillón rojo.	niña, estar, sentado, en, un, sillón, rojo | The girl is sitting in a red armchair.	girl, sit, a, red, armchair
Juan se encontró con un mago.	Juan, se, encontrar, un, mago | Juan met a magician.	Juan, meet, a, magician
¿A dónde vas Caperucita?	a, dónde, ir, Caperucita | Where are you going Little Red Riding Hood?	where, you, go, Little Red Riding Hood, ?
El cerdito va a jugar.	cerdito, ir, jugar | The piglet is going to play.	piglet, play
La niña está sentada en las escaleras.	niña, estar, sentado, escaleras | The girl is sitting on the stairs.	girl, sit, stairs
El caracol se puso triste.	caracol, se, poner, triste | The snail became sad.	snail, become, sad
Las tiró por la ventana.	tirar, ventana | He threw them out the window.	he, throw, them, out, window
El perro fue por la carretera.	perro, ir, carretera | The dog went on the road.	dog, go, road
Todos los niños se asustaron.	todo, niños, se, asustar | All the children were scared.	all, children, be, scared
Ramón me regaló una rosa roja.	Ramón, me, regalar, un, rosa, rojo | Ramón gave me a red rose.	Ramón, give, me, a, red, rose
Enrique me regaló un ramo de rosas.	Enrique, me, regalar, un, ramo, de, rosas | Enrique gave me a bouquet of roses.	Enrique, give, me, a, bouquet, of, roses
El niño bebe en la botella.	niño, beber, botella | The baby drinks in the bottle.	baby, drink, bottle
La niña escribe en la arena.	niña, escribir, arena | The girl writes on the sand.	girl, write, sand
Las niñas corren con la cometa.	niñas, correr, cometa | Girls run with the kite.	girls, run, kite
Los niños juegan en la piscina.	niño, jugar, piscina | Children play in the pool.	children, play, pool
Los niños juegan en el parque.	niños, jugar, parque | The kids play in the park.	kids, play, park
La niña bebe en el vaso.	niña, beber, vaso | The girl drinks in the glass.	girl, drink, glass
La Luna está en el cielo.	Luna, estar, cielo | The moon is in the sky.	moon, be, sky
El niño escribe en la ventana con el dedo.	niño, escribir, ventana, con, dedo | The boy writes on the window with his finger.	boy, write, window, with, his, finger
El tren va por el mar.	tren, ir, mar | The train goes by the sea.	train, go, sea
La libélula vuela en el lago.	libélula, volar, lago | The dragonfly flies in the lake.	dragonfly, fly, lake
Blancanieves corre al bosque.	Blancanieves, correr, bosque | Snow White runs to the forest.	Snow White, run, forest
Yo quiero ir al baño.	yo, querer, ir, baño | I want to go to the bathroom.	want, to, go, bathroom
El gallo canta por la mañana.	gallo, cantar, mañana | The cock sings in the morning.	cock, sing, morning
El bebé juega en el parquet.	bebé, jugar, parquet | The baby plays in the parquet.	baby, play, parquet
Ricitos de Oro duerme en la cama pequeña.	Ricitos, de, Oro, dormir, cama, pequeño | Goldilocks sleeps in the small bed.	Goldilocks, sleep, small, bed
Los niños juegan al corro.	niños, jugar, corro | The children play at the corro.	children, play, corro
Yo quiero jugar al ordenador.	yo, querer, jugar, ordenador | I want to play on the computer.	want, to, play, computer
Yo hago pis en el váter.	yo, hacer, pis, en, váter | I pee on the toilet.	pee, toilet
El cabritillo pequeño está en el reloj.	cabritillo, pequeño, estar, reloj | The little goat is in the clock.	little, goat, be, clock
El niño duerme con el osito.	niño, dormir, osito | The child sleeps with the little bear.	child, sleep, little, bear
Los pingüinos patinan en la nieve con gorros y bufandas.	pingüinos, patinar, nieve, con, gorros, bufandas | The penguins skate in the snow with hats and scarves.	penguins, skate, snow, with, hats, scarves
El tren va por la vía.	tren, ir, vía | The train is on the road.	train, be, road
Los niños saltan en la cama.	niños, saltar, cama | Children jump in bed.	children, jump, bed
El perro pasea con el collar.	perro, pasear, collar | The dog walks with the collar.	dog, walk, collar
El niño se sube a las rocas.	niño, se, subir, rocas | The boy climbs on the rocks.	boy, climb, rocks
Ricitos de Oro duerme en la cama.	Ricitos, de, Oro, dormir, cama | Goldilocks sleeps in bed.	Goldilocks, sleep, bed
El gallo canta por la noche.	gallo, cantar, noche | The cock sings at night.	cock, sing, night
Yo duermo por la noche.	yo, dormir, noche | I sleep at night.	sleep, night
El niño pasea por la calle.	niño, pasear, calle | The boy walks on the street.	boy, walk, street
Papá Noel va en trineo con renos.	Papá, Noel, ir, trineo, con, renos | Santa goes in sleigh with reindeers.	Santa, go, sleigh, with, reindeers
El niño juega con la pala y el cubo.	niño, jugar, pala, cubo | The child plays with the shovel and the bucket.	child, play, shovel, bucket
La niña patina con los patines y el casco.	niña, patinar, patines, casco | The girl skates with skates and helmet.	girl, skate, skates, helmet
Los niños juegan con el barco y el tren.	niños, jugar, barco, tren | Children play with the boat and the train.	children, play, boat, train
Anabel pinta en el papel.	Anabel, pintar, papel | Anabel paints on the paper.	Anabel, paint, paper
Los Reyes Magos van en camello.	Reyes, mago, ir, camello | The Three Wise Men go on a camel.	Three Wise Men, go, a, camel
Marcelina está montando el belén en su casa.	Marcelina, estar, montar, belén, en, su, casa | Marcelina is setting up the nativity scene in her house.	Marcelina, prepare, nativity, scene, in, her, house
Los Reyes Magos traen regalo.	reyes, mago, traer, regalo | The Three Wise Men bring a gift.	Three Wise Men, bring, a, gift
Juan vivía con su mamá.	Juan, vivir, su, mamá | Juan lived with his mother.	Juan, live, his, mother
Caperucita asombrada preguntó a la abuela.	Caperucita, asombrado, preguntar, abuela | Little Red Riding Hood stunned asked the grandmother.	Little Red Riding Hood, stunned, ask, grandmother
Cayó sal al mantel.	caer, sal, a, mantel | Salt fell on the tablecloth.	salt, fall, tablecloth
La pata es negra y peluda.	pata, ser, negro, peludo | The leg is black and hairy.	leg, be, black
Los amigos de la bruja lo vieron bailar.	amigos, de, bruja, lo, ver, bailar | The witch's friends saw him dancing.	witch's friends, see, him, dance
Juan bajó por la planta.	juan, bajar, planta | Juan went down the plant.	Juan, go, plant
El señor Pondio cuida de los animals.	señor, Pondio, cuidar, animales | Mr. Pondio takes care of the animals.	Mr. Pondio, care, animals
El caracol Ramón no sabe como vestirse.	caracol, Ramó, no, saber, como, vestir, se | The snail Ramón does not know how to dress.	snail, Ramón, know, how, to, dress, not
Juán se llevó la gallina y el arpa mágica.	Juán, se, llevar, gallina, arpa, mágico | Juan took away the hen and the magic harp.	Juan, take, hen, magic, harp
¿Quién es la más guapa?	quién, ser, más, guapo, ? | Who is the prettiest?	who, prettiest, be, ?
El domingo de ramos vamos a ver la borriquita.	domingo, de, ramos, ir, ver, borriquita | On Palm Sunday we will see the little donkey.	we, see, little, donkey, on, Palm Sunday
Yo escribo una carta para los Reyes Magos.	yo, escribir, un, carta, para, Reyes, mago | I write a letter for the Three Wise Men.	write, a, letter, for, Three Wise Men
El lobo llamó a la puerta.	lobo, llamar, puerta | The wolf knocked on the door.	wolf, knock, door
Ese señor va a pasear al pinar.	ese, señor, ir, pasear, a, pinar | That gentleman is going to walk along the pine forest.	that, gentleman, walk, pine, forest
Mamá pato paseaba con sus hijos.	mamá, pato, pasear, su, hijos | Mom Duck walked with her children.	mom, duck, walk, her, children
La burra cayó al barro.	burro, caer, barro | The donkey fell into the mud.	donkey, fall, mud
Me gustan los churros rellenos.	me, gustar, churros, relleno | I like stuffed churros.	like, stuffed, churros
El lunes comeré lentejas.	lunes, comer, lentejas | On Monday I will eat lentils.	eat, lentils, on, Monday
La cabrita pequeña se escondió debajo de la cama.	cabrita, pequeño, se, esconder, debajo, de, cama | The little goat hid under the bed.	little, goat, hide, bed
La Tierra es redonda.	Tierra, ser, redondo | The Earth is round.	Earth, be, round
El lobo quiere comerlo.	lobo, querer, comer, lo | The wolf wants to eat it.	wolf, eat, it
El lobo quiere comerlos.	lobo, querer, comer, lo | The wolf wants to eat them.	wolf, eat, them
Yo quiero ir a la Luna.	yo, querer, ir, Luna | I want to go to the Moon.	go, to, Moon
El lobo quiere comer a los cabritillos.	lobo, querer, comer, cabritillos | The wolf wants to eat the kids.	wolf, eat, kids
Caperucita se entretuvo cogiendo flores para la abuelita.	Caperucita, se, entretener, coger, flores, para, abuelita | Little Red Riding Hood got busy picking flowers for Granny.	Little Red Riding Hood, get, busy
El niño lee un libro con la linterna debajo de la sábana.	niño, leer, un, libro, con, linterna, debajo, de, sábana | The child reads a book with the flashlight under the sheet.	child, read, a, book, with, flashlight
La lechera era una niña alegre y soñadora.	lechera, ser, niña, alegre, soñador | The milkmaid was a cheerful and dreamy girl.	milkmaid, be, a, cheerful, girl
Marcelina sale a buscarlos.	Marcelina, salir, buscar, los | Marcelina goes out to look for them.	Marcelina, go, out
El papá lee un cuento a la niña en la cama.	papá, leer, un, cuento, a, niña, en, cama | Dad reads a story to the girl in bed.	dad, read, a, story, to, girl
La mujer coge melocotones del árbol con su cesto.	mujer, coger, melocotones, de, árbol, con, su, cesto | The woman picks peaches from the tree with her basket.	woman, pick, peaches, from, tree
Dorita vivía en una granja con sus tíos y su perrito Totó.	Dorita, vivir, un, granja, con, su, tíos, su, perrito, Totó | Dorita lived on a farm with her uncles and her little dog Totó.	Dorita, live, a, farm, with, her, uncles
La niña bebe un batido de chocolate con dos pajitas.	niña, beber, batido, de, chocolate, con, dos, pajitas | The girl drinks a chocolate milkshake with two straws.	girl, drink, a, milkshake, with, two, straws
Abuelita qué orejas grandes tienes.	abuelita, qué, orejas, grande, tener | Granny what big ears you have.	granny, what, big, ears, you, have
Son para oirte bien.	ser, para, oir, te, bien | They are to hear you well.	they, be, to, hear, you, well
La madrastra no deja ir a Cenicienta a la fiesta.	madrastra, no, dejar, ir, Cenicienta, a, fiesta | The stepmother does not let Cinderella go to the party.	stepmother, let, Cinderella, go, party, not
Abuelita qué ojos grandes tienes.	abuelita, qué, ojos, grande, tener | Granny what big eyes you have.	granny, what, big, eyes, you, have
Es para comerte.	ser, comer, te | It is to eat you.	it, be, to, eat, you
Son para verte bien.	ser, ver, te, bien | They are to see you well.	they, be, to, see, you, well
Abuelita qué boca grande tienes.	abuelita, qué, boca, grande, tener | Granny what a big mouth you have.	granny, what, a, big, mouth, you, have